"filename", "language", "C++", "XML", "comment", "blank", "total"
"g:\Projects\C_CPP\Clion\NGS\include\NGS\NGS.h", "C++", 30, 0, 39, 15, 84
"g:\Projects\C_CPP\Clion\NGS\include\NGS\NGS.hpp", "C++", 22, 0, 0, 9, 31
"g:\Projects\C_CPP\Clion\NGS\include\NGS\NGS.vcxproj", "XML", 0, 390, 0, 0, 390
"g:\Projects\C_CPP\Clion\NGS\include\NGS\algorithm\PID.h", "C++", 55, 0, 84, 13, 152
"g:\Projects\C_CPP\Clion\NGS\include\NGS\algorithm\PID.hpp", "C++", 165, 0, 38, 52, 255
"g:\Projects\C_CPP\Clion\NGS\include\NGS\algorithm\algorithm.h", "C++", 6, 0, 0, 3, 9
"g:\Projects\C_CPP\Clion\NGS\include\NGS\algorithm\algorithm.hpp", "C++", 3, 0, 0, 3, 6
"g:\Projects\C_CPP\Clion\NGS\include\NGS\algorithm\dynamic_program.h", "C++", 1, 0, 0, 1, 2
"g:\Projects\C_CPP\Clion\NGS\include\NGS\base\STL.h", "C++", 52, 0, 17, 18, 87
"g:\Projects\C_CPP\Clion\NGS\include\NGS\base\assert.h", "C++", 57, 0, 1, 12, 70
"g:\Projects\C_CPP\Clion\NGS\include\NGS\base\base.h", "C++", 18, 0, 13, 10, 41
"g:\Projects\C_CPP\Clion\NGS\include\NGS\base\base.hpp", "C++", 2, 0, 0, 1, 3
"g:\Projects\C_CPP\Clion\NGS\include\NGS\base\base_class.h", "C++", 26, 0, 7, 7, 40
"g:\Projects\C_CPP\Clion\NGS\include\NGS\base\bit.h", "C++", 134, 0, 10, 43, 187
"g:\Projects\C_CPP\Clion\NGS\include\NGS\base\boost\boost.h", "C++", 3, 0, 0, 2, 5
"g:\Projects\C_CPP\Clion\NGS\include\NGS\base\boost\mpl.h", "C++", 20, 0, 0, 10, 30
"g:\Projects\C_CPP\Clion\NGS\include\NGS\base\boost\property_tree.h", "C++", 3, 0, 0, 2, 5
"g:\Projects\C_CPP\Clion\NGS\include\NGS\base\concepts.h", "C++", 44, 0, 1, 20, 65
"g:\Projects\C_CPP\Clion\NGS\include\NGS\base\config.h", "C++", 25, 0, 7, 12, 44
"g:\Projects\C_CPP\Clion\NGS\include\NGS\base\defined.h", "C++", 130, 0, 26, 49, 205
"g:\Projects\C_CPP\Clion\NGS\include\NGS\base\log.h", "C++", 190, 0, 3, 25, 218
"g:\Projects\C_CPP\Clion\NGS\include\NGS\base\memory_reinterpreter.h", "C++", 29, 0, 0, 10, 39
"g:\Projects\C_CPP\Clion\NGS\include\NGS\base\mpl\bitmap.h", "C++", 45, 0, 0, 9, 54
"g:\Projects\C_CPP\Clion\NGS\include\NGS\base\mpl\concepts\algorithm.h", "C++", 1, 0, 0, 1, 2
"g:\Projects\C_CPP\Clion\NGS\include\NGS\base\mpl\concepts\concept.h", "C++", 7, 0, 0, 1, 8
"g:\Projects\C_CPP\Clion\NGS\include\NGS\base\mpl\concepts\data_type.h", "C++", 20, 0, 2, 6, 28
"g:\Projects\C_CPP\Clion\NGS\include\NGS\base\mpl\concepts\iterator.h", "C++", 25, 0, 7, 9, 41
"g:\Projects\C_CPP\Clion\NGS\include\NGS\base\mpl\concepts\meta_function.h", "C++", 31, 0, 2, 11, 44
"g:\Projects\C_CPP\Clion\NGS\include\NGS\base\mpl\concepts\same.h", "C++", 13, 0, 0, 8, 21
"g:\Projects\C_CPP\Clion\NGS\include\NGS\base\mpl\concepts\sequence.h", "C++", 28, 0, 1, 7, 36
"g:\Projects\C_CPP\Clion\NGS\include\NGS\base\mpl\defined.h", "C++", 1, 0, 0, 0, 1
"g:\Projects\C_CPP\Clion\NGS\include\NGS\base\mpl\find.h", "C++", 35, 0, 19, 15, 69
"g:\Projects\C_CPP\Clion\NGS\include\NGS\base\mpl\function.h", "C++", 32, 0, 32, 12, 76
"g:\Projects\C_CPP\Clion\NGS\include\NGS\base\mpl\mpl.h", "C++", 14, 0, 0, 5, 19
"g:\Projects\C_CPP\Clion\NGS\include\NGS\base\mpl\mpl_macro.h", "C++", 21, 0, 3, 9, 33
"g:\Projects\C_CPP\Clion\NGS\include\NGS\base\mpl\promote_type.h", "C++", 9, 0, 0, 4, 13
"g:\Projects\C_CPP\Clion\NGS\include\NGS\base\mpl\sequence\at.h", "C++", 6, 0, 0, 6, 12
"g:\Projects\C_CPP\Clion\NGS\include\NGS\base\mpl\sequence\sequence.h", "C++", 16, 0, 0, 6, 22
"g:\Projects\C_CPP\Clion\NGS\include\NGS\base\mpl\struct\spread.h", "C++", 35, 0, 7, 9, 51
"g:\Projects\C_CPP\Clion\NGS\include\NGS\base\mpl\struct\struct.h", "C++", 78, 0, 12, 26, 116
"g:\Projects\C_CPP\Clion\NGS\include\NGS\base\mpl\struct\var.h", "C++", 38, 0, 0, 10, 48
"g:\Projects\C_CPP\Clion\NGS\include\NGS\base\mpl\struct\vars.h", "C++", 13, 0, 0, 6, 19
"g:\Projects\C_CPP\Clion\NGS\include\NGS\base\mpl\template_extraction.h", "C++", 35, 0, 7, 13, 55
"g:\Projects\C_CPP\Clion\NGS\include\NGS\base\mpl\utility.h", "C++", 18, 0, 0, 4, 22
"g:\Projects\C_CPP\Clion\NGS\include\NGS\base\space_transform.h", "C++", 7, 0, 0, 6, 13
"g:\Projects\C_CPP\Clion\NGS\include\NGS\base\template_mate.h", "C++", 25, 0, 0, 4, 29
"g:\Projects\C_CPP\Clion\NGS\include\NGS\base\type_info.h", "C++", 115, 0, 5, 19, 139
"g:\Projects\C_CPP\Clion\NGS\include\NGS\base\type_trait.h", "C++", 7, 0, 0, 8, 15
"g:\Projects\C_CPP\Clion\NGS\include\NGS\base\utility.h", "C++", 23, 0, 0, 8, 31
"g:\Projects\C_CPP\Clion\NGS\include\NGS\base\version.h", "C++", 87, 0, 10, 35, 132
"g:\Projects\C_CPP\Clion\NGS\include\NGS\concepts\any.h", "C++", 6, 0, 0, 5, 11
"g:\Projects\C_CPP\Clion\NGS\include\NGS\concepts\concepts.h", "C++", 5, 0, 0, 2, 7
"g:\Projects\C_CPP\Clion\NGS\include\NGS\concepts\constant.h", "C++", 9, 0, 0, 5, 14
"g:\Projects\C_CPP\Clion\NGS\include\NGS\concepts\defined.h", "C++", 6, 0, 0, 4, 10
"g:\Projects\C_CPP\Clion\NGS\include\NGS\concepts\derived.h", "C++", 6, 0, 3, 6, 15
"g:\Projects\C_CPP\Clion\NGS\include\NGS\concepts\fundamental.h", "C++", 4, 0, 0, 2, 6
"g:\Projects\C_CPP\Clion\NGS\include\NGS\concepts\fundamental\floating.h", "C++", 6, 0, 0, 5, 11
"g:\Projects\C_CPP\Clion\NGS\include\NGS\concepts\fundamental\int.h", "C++", 6, 0, 0, 5, 11
"g:\Projects\C_CPP\Clion\NGS\include\NGS\concepts\fundamental\uint.h", "C++", 6, 0, 0, 5, 11
"g:\Projects\C_CPP\Clion\NGS\include\NGS\embedded\Interface.h", "C++", 15, 0, 0, 9, 24
"g:\Projects\C_CPP\Clion\NGS\include\NGS\embedded\bus\bus.h", "C++", 7, 0, 0, 2, 9
"g:\Projects\C_CPP\Clion\NGS\include\NGS\embedded\bus\bus_base.h", "C++", 34, 0, 0, 16, 50
"g:\Projects\C_CPP\Clion\NGS\include\NGS\embedded\bus\i2c\I2C.h", "C++", 100, 0, 71, 23, 194
"g:\Projects\C_CPP\Clion\NGS\include\NGS\embedded\bus\serial_port\serial_port.h", "C++", 19, 0, 0, 10, 29
"g:\Projects\C_CPP\Clion\NGS\include\NGS\embedded\bus\spi\SPI.h", "C++", 19, 0, 0, 9, 28
"g:\Projects\C_CPP\Clion\NGS\include\NGS\embedded\bus\uart\UART.h", "C++", 19, 0, 0, 10, 29
"g:\Projects\C_CPP\Clion\NGS\include\NGS\embedded\bus\usb\UVC.h", "C++", 11, 0, 0, 9, 20
"g:\Projects\C_CPP\Clion\NGS\include\NGS\embedded\embedded.h", "C++", 6, 0, 0, 4, 10
"g:\Projects\C_CPP\Clion\NGS\include\NGS\embedded\embedded.hpp", "C++", 2, 0, 0, 1, 3
"g:\Projects\C_CPP\Clion\NGS\include\NGS\embedded\io\GPIO.h", "C++", 46, 0, 0, 14, 60
"g:\Projects\C_CPP\Clion\NGS\include\NGS\embedded\io\IO.h", "C++", 11, 0, 0, 9, 20
"g:\Projects\C_CPP\Clion\NGS\include\NGS\embedded\io\PWM.h", "C++", 15, 0, 0, 8, 23
"g:\Projects\C_CPP\Clion\NGS\include\NGS\esp\ESP.h", "C++", 4, 0, 0, 4, 8
"g:\Projects\C_CPP\Clion\NGS\include\NGS\esp\ESP.hpp", "C++", 6, 0, 0, 4, 10
"g:\Projects\C_CPP\Clion\NGS\include\NGS\esp\bus\i2c\I2C.hpp", "C++", 187, 0, 7, 44, 238
"g:\Projects\C_CPP\Clion\NGS\include\NGS\esp\defined.h", "C++", 7, 0, 0, 7, 14
"g:\Projects\C_CPP\Clion\NGS\include\NGS\esp\esp.vcxproj", "XML", 0, 159, 0, 0, 159
"g:\Projects\C_CPP\Clion\NGS\include\NGS\esp\esp_idf.h", "C++", 11, 0, 0, 4, 15
"g:\Projects\C_CPP\Clion\NGS\include\NGS\esp\io\GPIO.hpp", "C++", 87, 0, 0, 25, 112
"g:\Projects\C_CPP\Clion\NGS\include\NGS\esp\io\PCNT.h", "C++", 24, 0, 0, 12, 36
"g:\Projects\C_CPP\Clion\NGS\include\NGS\esp\io\PCNT.hpp", "C++", 117, 0, 2, 28, 147
"g:\Projects\C_CPP\Clion\NGS\include\NGS\esp\io\PWM.hpp", "C++", 78, 0, 0, 25, 103
"g:\Projects\C_CPP\Clion\NGS\include\NGS\extend\byte_array.h", "C++", 69, 0, 0, 10, 79
"g:\Projects\C_CPP\Clion\NGS\include\NGS\extend\color\channel.h", "C++", 66, 0, 4, 15, 85
"g:\Projects\C_CPP\Clion\NGS\include\NGS\extend\color\color.h", "C++", 6, 0, 0, 3, 9
"g:\Projects\C_CPP\Clion\NGS\include\NGS\extend\color\color_old.h", "C++", 141, 0, 0, 30, 171
"g:\Projects\C_CPP\Clion\NGS\include\NGS\extend\color\concept.h", "C++", 10, 0, 0, 5, 15
"g:\Projects\C_CPP\Clion\NGS\include\NGS\extend\color\defined.h", "C++", 20, 0, 0, 11, 31
"g:\Projects\C_CPP\Clion\NGS\include\NGS\extend\color\hsv.h", "C++", 29, 0, 3, 11, 43
"g:\Projects\C_CPP\Clion\NGS\include\NGS\extend\color\primary_color.h", "C++", 156, 0, 1, 29, 186
"g:\Projects\C_CPP\Clion\NGS\include\NGS\extend\command_queue.h", "C++", 18, 0, 0, 8, 26
"g:\Projects\C_CPP\Clion\NGS\include\NGS\extend\console.h", "C++", 12, 0, 0, 9, 21
"g:\Projects\C_CPP\Clion\NGS\include\NGS\extend\console.hpp", "C++", 191, 0, 0, 27, 218
"g:\Projects\C_CPP\Clion\NGS\include\NGS\extend\debug.h", "C++", 44, 0, 0, 10, 54
"g:\Projects\C_CPP\Clion\NGS\include\NGS\extend\event.h", "C++", 130, 0, 67, 22, 219
"g:\Projects\C_CPP\Clion\NGS\include\NGS\extend\extend.h", "C++", 22, 0, 8, 5, 35
"g:\Projects\C_CPP\Clion\NGS\include\NGS\extend\extend.hpp", "C++", 3, 0, 0, 3, 6
"g:\Projects\C_CPP\Clion\NGS\include\NGS\extend\factory.h", "C++", 32, 0, 0, 9, 41
"g:\Projects\C_CPP\Clion\NGS\include\NGS\extend\file.h", "C++", 64, 0, 0, 7, 71
"g:\Projects\C_CPP\Clion\NGS\include\NGS\extend\function.h", "C++", 8, 0, 0, 4, 12
"g:\Projects\C_CPP\Clion\NGS\include\NGS\extend\memory.h", "C++", 195, 0, 10, 37, 242
"g:\Projects\C_CPP\Clion\NGS\include\NGS\extend\movie.h", "C++", 87, 0, 5, 16, 108
"g:\Projects\C_CPP\Clion\NGS\include\NGS\extend\parser.h", "C++", 145, 0, 46, 20, 211
"g:\Projects\C_CPP\Clion\NGS\include\NGS\extend\selector.h", "C++", 4, 0, 0, 6, 10
"g:\Projects\C_CPP\Clion\NGS\include\NGS\extend\setting.h", "C++", 39, 0, 2, 16, 57
"g:\Projects\C_CPP\Clion\NGS\include\NGS\extend\stream.h", "C++", 109, 0, 6, 21, 136
"g:\Projects\C_CPP\Clion\NGS\include\NGS\extend\timer.h", "C++", 65, 0, 1, 12, 78
"g:\Projects\C_CPP\Clion\NGS\include\NGS\extend\tree.h", "C++", 58, 0, 0, 23, 81
"g:\Projects\C_CPP\Clion\NGS\include\NGS\extend\user_data.h", "C++", 8, 0, 0, 5, 13
"g:\Projects\C_CPP\Clion\NGS\include\NGS\graphic\api\graphic.h", "C++", 4, 0, 0, 6, 10
"g:\Projects\C_CPP\Clion\NGS\include\NGS\graphic\api\image.h", "C++", 31, 0, 2, 9, 42
"g:\Projects\C_CPP\Clion\NGS\include\NGS\graphic\api\renderer.h", "C++", 11, 0, 0, 10, 21
"g:\Projects\C_CPP\Clion\NGS\include\NGS\graphic\api\texture.h", "C++", 12, 0, 1, 5, 18
"g:\Projects\C_CPP\Clion\NGS\include\NGS\graphic\api\window.h", "C++", 26, 0, 0, 7, 33
"g:\Projects\C_CPP\Clion\NGS\include\NGS\graphic\graph.h", "C++", 6, 0, 0, 2, 8
"g:\Projects\C_CPP\Clion\NGS\include\NGS\math\BTL.h", "C++", 6, 0, 0, 5, 11
"g:\Projects\C_CPP\Clion\NGS\include\NGS\math\defined.h", "C++", 4, 0, 0, 3, 7
"g:\Projects\C_CPP\Clion\NGS\include\NGS\math\line.h", "C++", 28, 0, 0, 9, 37
"g:\Projects\C_CPP\Clion\NGS\include\NGS\math\math.h", "C++", 9, 0, 0, 3, 12
"g:\Projects\C_CPP\Clion\NGS\include\NGS\math\math.hpp", "C++", 2, 0, 0, 1, 3
"g:\Projects\C_CPP\Clion\NGS\include\NGS\math\matrix.h", "C++", 247, 0, 11, 27, 285
"g:\Projects\C_CPP\Clion\NGS\include\NGS\math\matrix_exp.h", "C++", 40, 0, 0, 12, 52
"g:\Projects\C_CPP\Clion\NGS\include\NGS\math\rectangle.h", "C++", 97, 0, 0, 17, 114
"g:\Projects\C_CPP\Clion\NGS\include\NGS\math\rotation.h", "C++", 26, 0, 3, 11, 40
"g:\Projects\C_CPP\Clion\NGS\include\NGS\math\transform.h", "C++", 23, 0, 0, 7, 30
"g:\Projects\C_CPP\Clion\NGS\include\NGS\math\util.h", "C++", 75, 0, 34, 19, 128
"g:\Projects\C_CPP\Clion\NGS\include\NGS\math\vector.h", "C++", 308, 0, 20, 40, 368
"g:\Projects\C_CPP\Clion\NGS\include\NGS\math\vector_exp.h", "C++", 32, 0, 0, 15, 47
"g:\Projects\C_CPP\Clion\NGS\include\NGS\math\vector_post.h", "C++", 241, 0, 38, 47, 326
"g:\Projects\C_CPP\Clion\NGS\include\NGS\mla\base\concepts.h", "C++", 4, 0, 0, 5, 9
"g:\Projects\C_CPP\Clion\NGS\include\NGS\mla\base\expression.h", "C++", 28, 0, 9, 11, 48
"g:\Projects\C_CPP\Clion\NGS\include\NGS\mla\base\tag.h", "C++", 7, 0, 0, 5, 12
"g:\Projects\C_CPP\Clion\NGS\include\NGS\mla\base\traits.h", "C++", 23, 0, 0, 8, 31
"g:\Projects\C_CPP\Clion\NGS\include\NGS\mla\defined.h", "C++", 10, 0, 0, 8, 18
"g:\Projects\C_CPP\Clion\NGS\include\NGS\mla\matrix\concepts.h", "C++", 17, 0, 0, 8, 25
"g:\Projects\C_CPP\Clion\NGS\include\NGS\mla\matrix\container.h", "C++", 11, 0, 0, 6, 17
"g:\Projects\C_CPP\Clion\NGS\include\NGS\mla\matrix\expression.h", "C++", 14, 0, 0, 5, 19
"g:\Projects\C_CPP\Clion\NGS\include\NGS\mla\matrix\tag.h", "C++", 7, 0, 0, 5, 12
"g:\Projects\C_CPP\Clion\NGS\include\NGS\mla\mla.h", "C++", 3, 0, 0, 2, 5
"g:\Projects\C_CPP\Clion\NGS\include\NGS\mla\scalar.h", "C++", 3, 0, 0, 1, 4
"g:\Projects\C_CPP\Clion\NGS\include\NGS\mla\scalar\binary.h", "C++", 6, 0, 0, 2, 8
"g:\Projects\C_CPP\Clion\NGS\include\NGS\mla\scalar\binary\assign.h", "C++", 7, 0, 0, 2, 9
"g:\Projects\C_CPP\Clion\NGS\include\NGS\mla\scalar\binary\assign\assign.h", "C++", 1, 0, 0, 1, 2
"g:\Projects\C_CPP\Clion\NGS\include\NGS\mla\scalar\binary\assign\divides.h", "C++", 1, 0, 0, 1, 2
"g:\Projects\C_CPP\Clion\NGS\include\NGS\mla\scalar\binary\assign\functor.h", "C++", 1, 0, 0, 1, 2
"g:\Projects\C_CPP\Clion\NGS\include\NGS\mla\scalar\binary\assign\minus.h", "C++", 1, 0, 0, 1, 2
"g:\Projects\C_CPP\Clion\NGS\include\NGS\mla\scalar\binary\assign\multiplies.h", "C++", 1, 0, 0, 1, 2
"g:\Projects\C_CPP\Clion\NGS\include\NGS\mla\scalar\binary\assign\plus.h", "C++", 1, 0, 0, 1, 2
"g:\Projects\C_CPP\Clion\NGS\include\NGS\mla\scalar\binary\assign\swap.h", "C++", 1, 0, 0, 1, 2
"g:\Projects\C_CPP\Clion\NGS\include\NGS\mla\scalar\binary\divides.h", "C++", 14, 0, 0, 5, 19
"g:\Projects\C_CPP\Clion\NGS\include\NGS\mla\scalar\binary\functor.h", "C++", 25, 0, 9, 8, 42
"g:\Projects\C_CPP\Clion\NGS\include\NGS\mla\scalar\binary\minus.h", "C++", 14, 0, 0, 5, 19
"g:\Projects\C_CPP\Clion\NGS\include\NGS\mla\scalar\binary\multiplies.h", "C++", 14, 0, 0, 5, 19
"g:\Projects\C_CPP\Clion\NGS\include\NGS\mla\scalar\binary\plus.h", "C++", 14, 0, 0, 5, 19
"g:\Projects\C_CPP\Clion\NGS\include\NGS\mla\scalar\traits.h", "C++", 13, 0, 0, 6, 19
"g:\Projects\C_CPP\Clion\NGS\include\NGS\mla\scalar\unary.h", "C++", 3, 0, 0, 2, 5
"g:\Projects\C_CPP\Clion\NGS\include\NGS\mla\scalar\unary\functor.h", "C++", 21, 0, 7, 8, 36
"g:\Projects\C_CPP\Clion\NGS\include\NGS\mla\scalar\unary\negate.h", "C++", 14, 0, 0, 5, 19
"g:\Projects\C_CPP\Clion\NGS\include\NGS\mla\vector.h", "C++", 6, 0, 0, 1, 7
"g:\Projects\C_CPP\Clion\NGS\include\NGS\mla\vector\binary.h", "C++", 5, 0, 0, 1, 6
"g:\Projects\C_CPP\Clion\NGS\include\NGS\mla\vector\binary\binary.h", "C++", 28, 0, 1, 9, 38
"g:\Projects\C_CPP\Clion\NGS\include\NGS\mla\vector\binary\functor.h", "C++", 23, 0, 10, 8, 41
"g:\Projects\C_CPP\Clion\NGS\include\NGS\mla\vector\binary\plus.h", "C++", 9, 0, 0, 5, 14
"g:\Projects\C_CPP\Clion\NGS\include\NGS\mla\vector\binary\traits.h", "C++", 14, 0, 0, 5, 19
"g:\Projects\C_CPP\Clion\NGS\include\NGS\mla\vector\expression.h", "C++", 23, 0, 10, 6, 39
"g:\Projects\C_CPP\Clion\NGS\include\NGS\mla\vector\tag.h", "C++", 7, 0, 0, 5, 12
"g:\Projects\C_CPP\Clion\NGS\include\NGS\mla\vector\unary.h", "C++", 5, 0, 0, 2, 7
"g:\Projects\C_CPP\Clion\NGS\include\NGS\mla\vector\unary\functor.h", "C++", 22, 0, 9, 7, 38
"g:\Projects\C_CPP\Clion\NGS\include\NGS\mla\vector\unary\negate.h", "C++", 9, 0, 0, 5, 14
"g:\Projects\C_CPP\Clion\NGS\include\NGS\mla\vector\unary\traits.h", "C++", 13, 0, 0, 6, 19
"g:\Projects\C_CPP\Clion\NGS\include\NGS\mla\vector\unary\unary.h", "C++", 25, 0, 1, 10, 36
"g:\Projects\C_CPP\Clion\NGS\include\NGS\mla\vector\vector.h", "C++", 51, 0, 13, 13, 77
"g:\Projects\C_CPP\Clion\NGS\include\NGS\nda\NDA.h", "C++", 7, 0, 0, 3, 10
"g:\Projects\C_CPP\Clion\NGS\include\NGS\nda\NDA.hpp", "C++", 1, 0, 0, 0, 1
"g:\Projects\C_CPP\Clion\NGS\include\NGS\nda\defined.h", "C++", 13, 0, 0, 7, 20
"g:\Projects\C_CPP\Clion\NGS\include\NGS\nda\display\bitmap\bitmap.h", "C++", 15, 0, 0, 7, 22
"g:\Projects\C_CPP\Clion\NGS\include\NGS\nda\display\bitmap\data.h", "C++", 67, 0, 2, 15, 84
"g:\Projects\C_CPP\Clion\NGS\include\NGS\nda\display\bitmap\data_view.h", "C++", 33, 0, 0, 10, 43
"g:\Projects\C_CPP\Clion\NGS\include\NGS\nda\display\bitmap\idata.h", "C++", 14, 0, 0, 9, 23
"g:\Projects\C_CPP\Clion\NGS\include\NGS\nda\display\display.h", "C++", 56, 0, 0, 15, 71
"g:\Projects\C_CPP\Clion\NGS\include\NGS\nda\display\sprite.h", "C++", 11, 0, 0, 6, 17
"g:\Projects\C_CPP\Clion\NGS\include\NGS\nda\display\stage.h", "C++", 11, 0, 0, 6, 17
"g:\Projects\C_CPP\Clion\NGS\include\NGS\nda\enum\blend.h", "C++", 21, 0, 0, 5, 26
"g:\Projects\C_CPP\Clion\NGS\include\NGS\nda\impl\opengl.h", "C++", 1, 0, 0, 1, 2
"g:\Projects\C_CPP\Clion\NGS\include\NGS\nda\impl\opengl\defined.h", "C++", 4, 0, 0, 5, 9
"g:\Projects\C_CPP\Clion\NGS\include\NGS\nda\impl\opengl\draw.h", "C++", 11, 0, 0, 9, 20
"g:\Projects\C_CPP\Clion\NGS\include\NGS\nda\impl\opengl\opengl.h", "C++", 1, 0, 0, 1, 2
"g:\Projects\C_CPP\Clion\NGS\include\NGS\nda\impl\opengl\space.h", "C++", 4, 0, 0, 6, 10
"g:\Projects\C_CPP\Clion\NGS\include\NGS\nda\interfaces\draw.h", "C++", 9, 0, 0, 5, 14
"g:\Projects\C_CPP\Clion\NGS\include\NGS\nda\interfaces\interfaces.h", "C++", 2, 0, 0, 1, 3
"g:\Projects\C_CPP\Clion\NGS\include\NGS\nda\transform.h", "C++", 12, 0, 0, 9, 21
"g:\Projects\C_CPP\Clion\NGS\include\NGS\ngl2\NGL.h", "C++", 26, 0, 0, 8, 34
"g:\Projects\C_CPP\Clion\NGS\include\NGS\ngl2\NGL.hpp", "C++", 2, 0, 0, 2, 4
"g:\Projects\C_CPP\Clion\NGS\include\NGS\ngl2\api\renderer.h", "C++", 19, 0, 0, 10, 29
"g:\Projects\C_CPP\Clion\NGS\include\NGS\ngl2\api\renderer.hpp", "C++", 10, 0, 0, 6, 16
"g:\Projects\C_CPP\Clion\NGS\include\NGS\ngl2\api\shader.h", "C++", 41, 0, 0, 13, 54
"g:\Projects\C_CPP\Clion\NGS\include\NGS\ngl2\api\texture.h", "C++", 41, 0, 0, 11, 52
"g:\Projects\C_CPP\Clion\NGS\include\NGS\ngl2\api\vertex.h", "C++", 6, 0, 0, 6, 12
"g:\Projects\C_CPP\Clion\NGS\include\NGS\ngl2\api\vertex_array.h", "C++", 276, 0, 3, 45, 324
"g:\Projects\C_CPP\Clion\NGS\include\NGS\ngl2\config.h", "C++", 13, 0, 0, 5, 18
"g:\Projects\C_CPP\Clion\NGS\include\NGS\ngl2\context.h", "C++", 107, 0, 9, 24, 140
"g:\Projects\C_CPP\Clion\NGS\include\NGS\ngl2\defined.h", "C++", 25, 0, 0, 11, 36
"g:\Projects\C_CPP\Clion\NGS\include\NGS\ngl2\fw\glfw.h", "C++", 92, 0, 1, 19, 112
"g:\Projects\C_CPP\Clion\NGS\include\NGS\ngl2\gl\blend.h", "C++", 19, 0, 0, 5, 24
"g:\Projects\C_CPP\Clion\NGS\include\NGS\ngl2\gl\buffer.h", "C++", 41, 0, 0, 12, 53
"g:\Projects\C_CPP\Clion\NGS\include\NGS\ngl2\gl\error.h", "C++", 20, 0, 1, 7, 28
"g:\Projects\C_CPP\Clion\NGS\include\NGS\ngl2\gl\framebuffer.h", "C++", 32, 0, 1, 8, 41
"g:\Projects\C_CPP\Clion\NGS\include\NGS\ngl2\gl\gl.h", "C++", 11, 0, 0, 2, 13
"g:\Projects\C_CPP\Clion\NGS\include\NGS\ngl2\gl\render.h", "C++", 29, 0, 5, 7, 41
"g:\Projects\C_CPP\Clion\NGS\include\NGS\ngl2\gl\renderbuffer.h", "C++", 22, 0, 0, 8, 30
"g:\Projects\C_CPP\Clion\NGS\include\NGS\ngl2\gl\shader.h", "C++", 96, 0, 1, 14, 111
"g:\Projects\C_CPP\Clion\NGS\include\NGS\ngl2\gl\space.h", "C++", 8, 0, 0, 9, 17
"g:\Projects\C_CPP\Clion\NGS\include\NGS\ngl2\gl\state.h", "C++", 23, 0, 0, 7, 30
"g:\Projects\C_CPP\Clion\NGS\include\NGS\ngl2\gl\texture.h", "C++", 49, 0, 0, 12, 61
"g:\Projects\C_CPP\Clion\NGS\include\NGS\ngl2\gl\vertex.h", "C++", 110, 0, 0, 32, 142
"g:\Projects\C_CPP\Clion\NGS\include\NGS\ngl2\gl\vertex_array.h", "C++", 58, 0, 21, 14, 93
"g:\Projects\C_CPP\Clion\NGS\include\NGS\ngl2\gl_enum.h", "C++", 276, 0, 0, 28, 304
"g:\Projects\C_CPP\Clion\NGS\include\NGS\ngl2\opengl.h", "C++", 3, 0, 0, 2, 5
"g:\Projects\C_CPP\Clion\NGS\include\NGS\ngl\NGL.h", "C++", 31, 0, 4, 12, 47
"g:\Projects\C_CPP\Clion\NGS\include\NGS\ngl\NGL.hpp", "C++", 10, 0, 4, 6, 20
"g:\Projects\C_CPP\Clion\NGS\include\NGS\ngl\base\buffer.h", "C++", 27, 0, 15, 7, 49
"g:\Projects\C_CPP\Clion\NGS\include\NGS\ngl\base\buffer.hpp", "C++", 62, 0, 0, 10, 72
"g:\Projects\C_CPP\Clion\NGS\include\NGS\ngl\base\buffer_target.h", "C++", 13, 0, 0, 6, 19
"g:\Projects\C_CPP\Clion\NGS\include\NGS\ngl\base\object.h", "C++", 13, 0, 0, 6, 19
"g:\Projects\C_CPP\Clion\NGS\include\NGS\ngl\base\opengl.h", "C++", 22, 0, 6, 14, 42
"g:\Projects\C_CPP\Clion\NGS\include\NGS\ngl\base\opengl.hpp", "C++", 36, 0, 0, 10, 46
"g:\Projects\C_CPP\Clion\NGS\include\NGS\ngl\base\state.h", "C++", 20, 0, 0, 8, 28
"g:\Projects\C_CPP\Clion\NGS\include\NGS\ngl\base\target.h", "C++", 22, 0, 0, 8, 30
"g:\Projects\C_CPP\Clion\NGS\include\NGS\ngl\config.h", "C++", 13, 0, 0, 5, 18
"g:\Projects\C_CPP\Clion\NGS\include\NGS\ngl\defined.h", "C++", 27, 0, 0, 11, 38
"g:\Projects\C_CPP\Clion\NGS\include\NGS\ngl\error.h", "C++", 20, 0, 1, 7, 28
"g:\Projects\C_CPP\Clion\NGS\include\NGS\ngl\gl_enum.h", "C++", 281, 0, 0, 28, 309
"g:\Projects\C_CPP\Clion\NGS\include\NGS\ngl\glfw.h", "C++", 112, 0, 1, 16, 129
"g:\Projects\C_CPP\Clion\NGS\include\NGS\ngl\ngl.vcxproj", "XML", 0, 177, 0, 0, 177
"g:\Projects\C_CPP\Clion\NGS\include\NGS\ngl\opengl.h", "C++", 3, 0, 0, 2, 5
"g:\Projects\C_CPP\Clion\NGS\include\NGS\ngl\shader\shader.h", "C++", 85, 0, 1, 15, 101
"g:\Projects\C_CPP\Clion\NGS\include\NGS\ngl\shader\shader.hpp", "C++", 7, 0, 0, 5, 12
"g:\Projects\C_CPP\Clion\NGS\include\NGS\ngl\shader\source.h", "C++", 63, 0, 0, 8, 71
"g:\Projects\C_CPP\Clion\NGS\include\NGS\ngl\texture\image_view.h", "C++", 28, 0, 0, 11, 39
"g:\Projects\C_CPP\Clion\NGS\include\NGS\ngl\texture\texture.h", "C++", 105, 0, 0, 26, 131
"g:\Projects\C_CPP\Clion\NGS\include\NGS\ngl\texture\texture.hpp", "C++", 10, 0, 0, 5, 15
"g:\Projects\C_CPP\Clion\NGS\include\NGS\ngl\utils\camera.h", "C++", 43, 0, 0, 10, 53
"g:\Projects\C_CPP\Clion\NGS\include\NGS\ngl\utils\renderer.h", "C++", 63, 0, 0, 21, 84
"g:\Projects\C_CPP\Clion\NGS\include\NGS\ngl\vertex\array\array.h", "C++", 62, 0, 3, 20, 85
"g:\Projects\C_CPP\Clion\NGS\include\NGS\ngl\vertex\array\base.h", "C++", 123, 0, 15, 18, 156
"g:\Projects\C_CPP\Clion\NGS\include\NGS\ngl\vertex\array\base.hpp", "C++", 10, 0, 0, 10, 20
"g:\Projects\C_CPP\Clion\NGS\include\NGS\ngl\vertex\array\indices.h", "C++", 57, 0, 0, 8, 65
"g:\Projects\C_CPP\Clion\NGS\include\NGS\ngl\vertex\array\line.h", "C++", 61, 0, 0, 7, 68
"g:\Projects\C_CPP\Clion\NGS\include\NGS\ngl\vertex\array\polygon.h", "C++", 109, 0, 0, 8, 117
"g:\Projects\C_CPP\Clion\NGS\include\NGS\ngl\vertex\concepts.h", "C++", 26, 0, 37, 10, 73
"g:\Projects\C_CPP\Clion\NGS\include\NGS\ngl\vertex\ctrl\default.h", "C++", 19, 0, 0, 9, 28
"g:\Projects\C_CPP\Clion\NGS\include\NGS\ngl\vertex\ctrl\line.h", "C++", 23, 0, 0, 8, 31
"g:\Projects\C_CPP\Clion\NGS\include\NGS\ngl\vertex\ctrl\polygon.h", "C++", 25, 0, 0, 8, 33
"g:\Projects\C_CPP\Clion\NGS\include\NGS\ngl\vertex\ctrl\vertex.h", "C++", 20, 0, 0, 10, 30
"g:\Projects\C_CPP\Clion\NGS\include\NGS\ngl\vertex\indices.h", "C++", 31, 0, 0, 12, 43
"g:\Projects\C_CPP\Clion\NGS\include\NGS\ngl\vertex\indices.hpp", "C++", 19, 0, 0, 10, 29
"g:\Projects\C_CPP\Clion\NGS\include\NGS\ngl\vertex\interface\IIndicesCtrl.h", "C++", 16, 0, 0, 7, 23
"g:\Projects\C_CPP\Clion\NGS\include\NGS\ngl\vertex\trait.h", "C++", 35, 0, 14, 6, 55
"g:\Projects\C_CPP\Clion\NGS\include\NGS\ngl\vertex\vertex.h", "C++", 83, 0, 0, 14, 97
"g:\Projects\C_CPP\Clion\NGS\include\NGS\ngl\vertex\vertex.hpp", "C++", 27, 0, 0, 6, 33
"g:\Projects\C_CPP\Clion\NGS\include\NGS\ngl\vertex\vertex_buffer.h", "C++", 35, 0, 0, 12, 47
"g:\Projects\C_CPP\Clion\NGS\include\NGS\ngl\vertex\vertex_buffer.hpp", "C++", 16, 0, 0, 7, 23
"g:\Projects\C_CPP\Clion\NGS\include\NGS\ngl\vertex\vertex_format.h", "C++", 62, 0, 30, 23, 115
"g:\Projects\C_CPP\Clion\NGS\include\NGS\nsl\NSL.h", "C++", 14, 0, 0, 10, 24
"g:\Projects\C_CPP\Clion\NGS\include\NGS\nsl\NSL.hpp", "C++", 7, 0, 0, 3, 10
"g:\Projects\C_CPP\Clion\NGS\include\NGS\nsl\NSL.vcxproj", "XML", 0, 220, 0, 0, 220
"g:\Projects\C_CPP\Clion\NGS\include\NGS\nsl\bus\i2c\I2C.hpp", "C++", 117, 0, 1, 38, 156
"g:\Projects\C_CPP\Clion\NGS\include\NGS\nsl\defined.h", "C++", 13, 0, 0, 9, 22
"g:\Projects\C_CPP\Clion\NGS\include\NGS\nsl\depend.h", "C++", 14, 0, 0, 5, 19
"g:\Projects\C_CPP\Clion\NGS\include\NGS\nsl\file\device_file.h", "C++", 10, 0, 0, 6, 16
"g:\Projects\C_CPP\Clion\NGS\include\NGS\nsl\file\file.h", "C++", 85, 0, 1, 21, 107
"g:\Projects\C_CPP\Clion\NGS\include\NGS\nsl\file\file.hpp", "C++", 42, 0, 0, 16, 58
"g:\Projects\C_CPP\Clion\NGS\include\NGS\nsl\io\GPIO.hpp", "C++", 168, 0, 2, 36, 206
"g:\Projects\C_CPP\Clion\NGS\include\NGS\nsl\io\MultiplexIO.h", "C++", 36, 0, 0, 10, 46
"g:\Projects\C_CPP\Clion\NGS\include\NGS\nsl\io\MultiplexIO.hpp", "C++", 21, 0, 1, 5, 27
"g:\Projects\C_CPP\Clion\NGS\include\NGS\nsl\media\V4L2.h", "C++", 47, 0, 0, 18, 65
"g:\Projects\C_CPP\Clion\NGS\include\NGS\nsl\media\V4L2.hpp", "C++", 280, 0, 10, 66, 356
"g:\Projects\C_CPP\Clion\NGS\include\NGS\nsl\media\frame_buffer.h", "C++", 23, 0, 0, 12, 35
"g:\Projects\C_CPP\Clion\NGS\include\NGS\nsl\media\frame_buffer.hpp", "C++", 59, 0, 0, 18, 77
"g:\Projects\C_CPP\Clion\NGS\include\NGS\nsw\NSW.h", "C++", 6, 0, 0, 4, 10
"g:\Projects\C_CPP\Clion\NGS\include\NGS\nsw\NSW.hpp", "C++", 4, 0, 0, 3, 7
"g:\Projects\C_CPP\Clion\NGS\include\NGS\nsw\bus\UART.hpp", "C++", 23, 0, 0, 10, 33
"g:\Projects\C_CPP\Clion\NGS\include\NGS\nsw\bus\serial_port.hpp", "C++", 81, 0, 0, 22, 103
"g:\Projects\C_CPP\Clion\NGS\include\NGS\nsw\defined.h", "C++", 9, 0, 0, 5, 14
"g:\Projects\C_CPP\Clion\NGS\include\NGS\nsw\depend.h", "C++", 2, 0, 0, 1, 3
"Total", "-", 10941, 946, 957, 2961, 15805